##################
#                #
#  P   O         #
#          X     #
#        X       #
##################
