##################
#                #
#  P   O         #
#          X     #
#                #
##################
